


SO git ./textures/texture_south.xpm
NO ./textures/eagle.xpm
EA ./textures/wood.xpm
WE ./textures/texture_west.xpm
S ./textures/sprite_3.xpm




F 82, 24, 79  

C   52 ,   224, 207      
R     800 600  


   111               
11111111111111111111111    1111
10000020000000111 11111   
11111N00111111111
11110111000111111111111111111111 1
110011111121211111111       101
1111  1110001111111111       1 
1111 1111111111
1111 11111