
SO ./textures/texture_south.xpm
NO ./textures/eagle.xpm
EA ./textures/wood.xpm
WE ./textures/texture_west.xpm
S ./textures/sprite_1.xpm
      
R   500 500          
F 82,  24 , 79              
C   52 ,   224, 255                

   111               
11111111111111111111111    1111
10000020000000111 11111   
11111000111111111
1111000000000111111111111111111111 1
110222222220000000111121211111111       
11111011111111N001111111111       1 
11111011 1111111111
111110011111
111110011111
111110011111
111110011111
111110011111
111110011111
111110011111
111110011111
111110011111
111110011111
111110011111
111110011111
111110011111
111110011111
111110011111
111110011111
111110011111
111110011111
111110011111
111112211111
111111111111