



SO ./textures/texture_south.xpm
NO ./textures/eagle.xpm
EA ./textures/wood.xpm
WE ./textures/texture_west.xpm
S ./textures/sprite_2.xpm

R 1000 900
F 82,  24 , 79              
C   52 ,   224, 255

11
121
1221
122111111111
1S21
1221
121
1011111111111111
101111111111111
101111111111111111
1000000000000001111
1111111111011111111
11111100000111111111
1111111100111111111
1111111100111111111
1100000000000000001
1000000000000000011
11000000000000000011
1100000000000000001
1000000000000000011
110000000000000000111
1000000000000000011111111111111111
1100000000000000001112222222222221
1000000000000000011222222222222221
1100000000000000001122222222222221
1111111000000001111112222222222221
111111111111110111111112222222222111111
111111111111110000000000000000000000011111
111111111111111111111111111111111111111111