
SO ./textures/texture_south.xpm
NO ./textures/eagle.xpm
EA ./textures/wood.xpm
WE ./textures/texture_west.xpm
S ./textures/sprite_2.xpm
      
R  800 502
F 82,  24 , 79              
C   52 ,   224, 255                



111111111111
100000000001
100000000001
100020000001
1002E2000001
100020000001
100000000001
100000000001
111111111111
1